M5FacesEncoder	KEYWORD1
begin	KEYWORD1
isPresent	KEYWORD1
setStepsPerClick	KEYWORD2
getStepsPerClick	KEYWORD2
getPosition	KEYWORD2
setPosition	KEYWORD2
getDirection	KEYWORD2
directionToString	KEYWORD2
isPressed	KEYWORD2
wasPressedFor	KEYWORD2
setRightRotationHandler	KEYWORD2
setLeftRotationHandler	KEYWORD2
setUpperOverflowHandler	KEYWORD2
setLowerOverflowHandler	KEYWORD2
setClickHandler	KEYWORD2
setPressedHandler	KEYWORD2
setReleasedHandler	KEYWORD2
loop	KEYWORD2
ENCODER_RIGHT	LITERAL1
ENCODER_LEFT	LITERAL1
PRESSED	LITERAL1
NOT_PRESSED	LITERAL1
ENCODER_I2C_ADDR	LITERAL1